animals
20 10
####################
#                  #
#########  #########
#                  #
#                  #
#                  #
#################  #
#                  #
# X                #
####################
6
@ 1 1
a 5 8
c 3 1
p 4 4
| 4 1
& 5 1