11 5
###########
#   #     #
#   #   # #
#       #X#
###########
1
@ 1 1