machines
20 10
####################
#                  #
#                  #
#                  #
#                  #
#                  #
#                  #
#                  #
# X                #
####################
12
@ 1 1
r 9 5
r 9 6
r 9 7
r 8 7
r 7 6
r 18 4
r 18 3
r 18 2
r 1 7
r 2 7
r 3 7
